*** ********
***    *****
*** **  ****
***   *  ***
***** ** ***
***** ** ***
***** ******
*****   ****
****  * ****
*   **  ****
* *    *****
* **********